11111111
1EC000P1
11111111
11111111